"filename", "language", "Markdown", "JavaScript", "JSON", "XML", "TypeScript", "comment", "blank", "total"
"d:\0_Projects\Link\.eslintrc.js", "JavaScript", 0, 25, 0, 0, 0, 6, 1, 32
"d:\0_Projects\Link\app.js", "JavaScript", 0, 78, 0, 0, 0, 11, 5, 94
"d:\0_Projects\Link\app.json", "JSON", 0, 0, 74, 0, 0, 0, 0, 74
"d:\0_Projects\Link\components\calendar\index.js", "JavaScript", 0, 218, 0, 0, 0, 26, 5, 249
"d:\0_Projects\Link\components\calendar\index.json", "JSON", 0, 0, 4, 0, 0, 0, 0, 4
"d:\0_Projects\Link\images\home\24hour.svg", "XML", 0, 0, 0, 3, 0, 0, 1, 4
"d:\0_Projects\Link\images\home\arrow.svg", "XML", 0, 0, 0, 3, 0, 0, 1, 4
"d:\0_Projects\Link\images\home\avatar.svg", "XML", 0, 0, 0, 3, 0, 0, 1, 4
"d:\0_Projects\Link\images\home\equ.svg", "XML", 0, 0, 0, 4, 0, 0, 1, 5
"d:\0_Projects\Link\images\home\goin.svg", "XML", 0, 0, 0, 4, 0, 0, 1, 5
"d:\0_Projects\Link\images\home\logo.svg", "XML", 0, 0, 0, 9, 0, 0, 1, 10
"d:\0_Projects\Link\images\home\plan.svg", "XML", 0, 0, 0, 3, 0, 0, 1, 4
"d:\0_Projects\Link\images\home\scan.svg", "XML", 0, 0, 0, 16, 0, 0, 1, 17
"d:\0_Projects\Link\images\home\type.svg", "XML", 0, 0, 0, 3, 0, 0, 1, 4
"d:\0_Projects\Link\images\home\wepay.svg", "XML", 0, 0, 0, 3, 0, 0, 1, 4
"d:\0_Projects\Link\images\home\体质检测.svg", "XML", 0, 0, 0, 3, 0, 0, 1, 4
"d:\0_Projects\Link\images\home\意见反馈.svg", "XML", 0, 0, 0, 3, 0, 0, 1, 4
"d:\0_Projects\Link\images\home\扫一扫.svg", "XML", 0, 0, 0, 3, 0, 0, 1, 4
"d:\0_Projects\Link\images\home\训练计划.svg", "XML", 0, 0, 0, 3, 0, 0, 1, 4
"d:\0_Projects\Link\images\member\tipbg.svg", "XML", 0, 0, 0, 5, 0, 0, 1, 6
"d:\0_Projects\Link\images\tipbg.svg", "XML", 0, 0, 0, 5, 0, 0, 1, 6
"d:\0_Projects\Link\images\user\arrow.svg", "XML", 0, 0, 0, 3, 0, 0, 1, 4
"d:\0_Projects\Link\images\user\coupon-icon.svg", "XML", 0, 0, 0, 3, 0, 0, 1, 4
"d:\0_Projects\Link\images\user\exchange-icon.svg", "XML", 0, 0, 0, 3, 0, 0, 1, 4
"d:\0_Projects\Link\images\user\fire.svg", "XML", 0, 0, 0, 3, 0, 0, 1, 4
"d:\0_Projects\Link\images\user\money-icon.svg", "XML", 0, 0, 0, 3, 0, 0, 1, 4
"d:\0_Projects\Link\images\user\order-icon.svg", "XML", 0, 0, 0, 3, 0, 0, 1, 4
"d:\0_Projects\Link\images\user\tree.svg", "XML", 0, 0, 0, 3, 0, 0, 1, 4
"d:\0_Projects\Link\images\user\user-icon.svg", "XML", 0, 0, 0, 3, 0, 0, 1, 4
"d:\0_Projects\Link\images\user\vip.svg", "XML", 0, 0, 0, 3, 0, 0, 1, 4
"d:\0_Projects\Link\miniprogram_npm\@vant\weapp\action-sheet\index.d.ts", "TypeScript", 0, 0, 0, 0, 1, 0, 1, 2
"d:\0_Projects\Link\miniprogram_npm\@vant\weapp\action-sheet\index.js", "JavaScript", 0, 73, 0, 0, 0, 0, 1, 74
"d:\0_Projects\Link\miniprogram_npm\@vant\weapp\action-sheet\index.json", "JSON", 0, 0, 8, 0, 0, 0, 1, 9
"d:\0_Projects\Link\miniprogram_npm\@vant\weapp\area\index.d.ts", "TypeScript", 0, 0, 0, 0, 1, 0, 1, 2
"d:\0_Projects\Link\miniprogram_npm\@vant\weapp\area\index.js", "JavaScript", 0, 232, 0, 0, 0, 3, 1, 236
"d:\0_Projects\Link\miniprogram_npm\@vant\weapp\area\index.json", "JSON", 0, 0, 6, 0, 0, 0, 1, 7
"d:\0_Projects\Link\miniprogram_npm\@vant\weapp\area\index.wxs", "XML", 0, 0, 0, 7, 0, 0, 2, 9
"d:\0_Projects\Link\miniprogram_npm\@vant\weapp\button\index.d.ts", "TypeScript", 0, 0, 0, 0, 1, 0, 1, 2
"d:\0_Projects\Link\miniprogram_npm\@vant\weapp\button\index.js", "JavaScript", 0, 67, 0, 0, 0, 0, 1, 68
"d:\0_Projects\Link\miniprogram_npm\@vant\weapp\button\index.json", "JSON", 0, 0, 7, 0, 0, 0, 1, 8
"d:\0_Projects\Link\miniprogram_npm\@vant\weapp\button\index.wxs", "XML", 0, 0, 0, 31, 0, 0, 9, 40
"d:\0_Projects\Link\miniprogram_npm\@vant\weapp\calendar\components\header\index.d.ts", "TypeScript", 0, 0, 0, 0, 1, 0, 1, 2
"d:\0_Projects\Link\miniprogram_npm\@vant\weapp\calendar\components\header\index.js", "JavaScript", 0, 45, 0, 0, 0, 0, 1, 46
"d:\0_Projects\Link\miniprogram_npm\@vant\weapp\calendar\components\header\index.json", "JSON", 0, 0, 3, 0, 0, 0, 1, 4
"d:\0_Projects\Link\miniprogram_npm\@vant\weapp\calendar\components\month\index.d.ts", "TypeScript", 0, 0, 0, 0, 6, 0, 1, 7
"d:\0_Projects\Link\miniprogram_npm\@vant\weapp\calendar\components\month\index.js", "JavaScript", 0, 157, 0, 0, 0, 1, 1, 159
"d:\0_Projects\Link\miniprogram_npm\@vant\weapp\calendar\components\month\index.json", "JSON", 0, 0, 3, 0, 0, 0, 1, 4
"d:\0_Projects\Link\miniprogram_npm\@vant\weapp\calendar\components\month\index.wxs", "XML", 0, 0, 0, 59, 0, 0, 13, 72
"d:\0_Projects\Link\miniprogram_npm\@vant\weapp\calendar\index.d.ts", "TypeScript", 0, 0, 0, 0, 1, 0, 1, 2
"d:\0_Projects\Link\miniprogram_npm\@vant\weapp\calendar\index.js", "JavaScript", 0, 352, 0, 0, 0, 8, 1, 361
"d:\0_Projects\Link\miniprogram_npm\@vant\weapp\calendar\index.json", "JSON", 0, 0, 10, 0, 0, 0, 1, 11
"d:\0_Projects\Link\miniprogram_npm\@vant\weapp\calendar\index.wxs", "XML", 0, 0, 0, 28, 0, 0, 10, 38
"d:\0_Projects\Link\miniprogram_npm\@vant\weapp\calendar\utils.d.ts", "TypeScript", 0, 0, 0, 0, 12, 0, 1, 13
"d:\0_Projects\Link\miniprogram_npm\@vant\weapp\calendar\utils.js", "JavaScript", 0, 97, 0, 0, 0, 0, 1, 98
"d:\0_Projects\Link\miniprogram_npm\@vant\weapp\calendar\utils.wxs", "XML", 0, 0, 0, 20, 0, 0, 6, 26
"d:\0_Projects\Link\miniprogram_npm\@vant\weapp\card\index.d.ts", "TypeScript", 0, 0, 0, 0, 1, 0, 1, 2
"d:\0_Projects\Link\miniprogram_npm\@vant\weapp\card\index.js", "JavaScript", 0, 51, 0, 0, 0, 0, 1, 52
"d:\0_Projects\Link\miniprogram_npm\@vant\weapp\card\index.json", "JSON", 0, 0, 6, 0, 0, 0, 1, 7
"d:\0_Projects\Link\miniprogram_npm\@vant\weapp\cell-group\index.d.ts", "TypeScript", 0, 0, 0, 0, 1, 0, 1, 2
"d:\0_Projects\Link\miniprogram_npm\@vant\weapp\cell-group\index.js", "JavaScript", 0, 13, 0, 0, 0, 0, 1, 14
"d:\0_Projects\Link\miniprogram_npm\@vant\weapp\cell-group\index.json", "JSON", 0, 0, 3, 0, 0, 0, 1, 4
"d:\0_Projects\Link\miniprogram_npm\@vant\weapp\cell\index.d.ts", "TypeScript", 0, 0, 0, 0, 1, 0, 1, 2
"d:\0_Projects\Link\miniprogram_npm\@vant\weapp\cell\index.js", "JavaScript", 0, 40, 0, 0, 0, 0, 1, 41
"d:\0_Projects\Link\miniprogram_npm\@vant\weapp\cell\index.json", "JSON", 0, 0, 6, 0, 0, 0, 1, 7
"d:\0_Projects\Link\miniprogram_npm\@vant\weapp\cell\index.wxs", "XML", 0, 0, 0, 15, 0, 0, 3, 18
"d:\0_Projects\Link\miniprogram_npm\@vant\weapp\checkbox-group\index.d.ts", "TypeScript", 0, 0, 0, 0, 1, 0, 1, 2
"d:\0_Projects\Link\miniprogram_npm\@vant\weapp\checkbox-group\index.js", "JavaScript", 0, 39, 0, 0, 0, 0, 1, 40
"d:\0_Projects\Link\miniprogram_npm\@vant\weapp\checkbox-group\index.json", "JSON", 0, 0, 3, 0, 0, 0, 1, 4
"d:\0_Projects\Link\miniprogram_npm\@vant\weapp\checkbox\index.d.ts", "TypeScript", 0, 0, 0, 0, 1, 0, 1, 2
"d:\0_Projects\Link\miniprogram_npm\@vant\weapp\checkbox\index.js", "JavaScript", 0, 79, 0, 0, 0, 0, 1, 80
"d:\0_Projects\Link\miniprogram_npm\@vant\weapp\checkbox\index.json", "JSON", 0, 0, 6, 0, 0, 0, 1, 7
"d:\0_Projects\Link\miniprogram_npm\@vant\weapp\checkbox\index.wxs", "XML", 0, 0, 0, 16, 0, 0, 5, 21
"d:\0_Projects\Link\miniprogram_npm\@vant\weapp\circle\canvas.d.ts", "TypeScript", 0, 0, 0, 0, 3, 1, 1, 5
"d:\0_Projects\Link\miniprogram_npm\@vant\weapp\circle\canvas.js", "JavaScript", 0, 46, 0, 0, 0, 1, 1, 48
"d:\0_Projects\Link\miniprogram_npm\@vant\weapp\circle\index.d.ts", "TypeScript", 0, 0, 0, 0, 1, 0, 1, 2
"d:\0_Projects\Link\miniprogram_npm\@vant\weapp\circle\index.js", "JavaScript", 0, 201, 0, 0, 0, 2, 1, 204
"d:\0_Projects\Link\miniprogram_npm\@vant\weapp\circle\index.json", "JSON", 0, 0, 3, 0, 0, 0, 1, 4
"d:\0_Projects\Link\miniprogram_npm\@vant\weapp\col\index.d.ts", "TypeScript", 0, 0, 0, 0, 1, 0, 1, 2
"d:\0_Projects\Link\miniprogram_npm\@vant\weapp\col\index.js", "JavaScript", 0, 11, 0, 0, 0, 0, 1, 12
"d:\0_Projects\Link\miniprogram_npm\@vant\weapp\col\index.json", "JSON", 0, 0, 3, 0, 0, 0, 1, 4
"d:\0_Projects\Link\miniprogram_npm\@vant\weapp\col\index.wxs", "XML", 0, 0, 0, 15, 0, 0, 4, 19
"d:\0_Projects\Link\miniprogram_npm\@vant\weapp\collapse-item\animate.d.ts", "TypeScript", 0, 0, 0, 0, 1, 1, 1, 3
"d:\0_Projects\Link\miniprogram_npm\@vant\weapp\collapse-item\animate.js", "JavaScript", 0, 43, 0, 0, 0, 0, 1, 44
"d:\0_Projects\Link\miniprogram_npm\@vant\weapp\collapse-item\index.d.ts", "TypeScript", 0, 0, 0, 0, 1, 0, 1, 2
"d:\0_Projects\Link\miniprogram_npm\@vant\weapp\collapse-item\index.js", "JavaScript", 0, 62, 0, 0, 0, 0, 1, 63
"d:\0_Projects\Link\miniprogram_npm\@vant\weapp\collapse-item\index.json", "JSON", 0, 0, 6, 0, 0, 0, 1, 7
"d:\0_Projects\Link\miniprogram_npm\@vant\weapp\collapse\index.d.ts", "TypeScript", 0, 0, 0, 0, 1, 0, 1, 2
"d:\0_Projects\Link\miniprogram_npm\@vant\weapp\collapse\index.js", "JavaScript", 0, 48, 0, 0, 0, 0, 1, 49
"d:\0_Projects\Link\miniprogram_npm\@vant\weapp\collapse\index.json", "JSON", 0, 0, 3, 0, 0, 0, 1, 4
"d:\0_Projects\Link\miniprogram_npm\@vant\weapp\common\color.d.ts", "TypeScript", 0, 0, 0, 0, 7, 0, 1, 8
"d:\0_Projects\Link\miniprogram_npm\@vant\weapp\common\color.js", "JavaScript", 0, 10, 0, 0, 0, 0, 1, 11
"d:\0_Projects\Link\miniprogram_npm\@vant\weapp\common\component.d.ts", "TypeScript", 0, 0, 0, 0, 3, 1, 1, 5
"d:\0_Projects\Link\miniprogram_npm\@vant\weapp\common\component.js", "JavaScript", 0, 43, 0, 0, 0, 5, 1, 49
"d:\0_Projects\Link\miniprogram_npm\@vant\weapp\common\relation.d.ts", "TypeScript", 0, 0, 0, 0, 14, 1, 1, 16
"d:\0_Projects\Link\miniprogram_npm\@vant\weapp\common\relation.js", "JavaScript", 0, 64, 0, 0, 0, 1, 1, 66
"d:\0_Projects\Link\miniprogram_npm\@vant\weapp\common\utils.d.ts", "TypeScript", 0, 0, 0, 0, 12, 2, 1, 15
"d:\0_Projects\Link\miniprogram_npm\@vant\weapp\common\utils.js", "JavaScript", 0, 113, 0, 0, 0, 0, 1, 114
"d:\0_Projects\Link\miniprogram_npm\@vant\weapp\common\validator.d.ts", "TypeScript", 0, 0, 0, 0, 9, 0, 1, 10
"d:\0_Projects\Link\miniprogram_npm\@vant\weapp\common\validator.js", "JavaScript", 0, 42, 0, 0, 0, 1, 1, 44
"d:\0_Projects\Link\miniprogram_npm\@vant\weapp\common\version.d.ts", "TypeScript", 0, 0, 0, 0, 7, 0, 1, 8
"d:\0_Projects\Link\miniprogram_npm\@vant\weapp\common\version.js", "JavaScript", 0, 58, 0, 0, 0, 0, 1, 59
"d:\0_Projects\Link\miniprogram_npm\@vant\weapp\config-provider\index.d.ts", "TypeScript", 0, 0, 0, 0, 1, 0, 1, 2
"d:\0_Projects\Link\miniprogram_npm\@vant\weapp\config-provider\index.js", "JavaScript", 0, 11, 0, 0, 0, 0, 1, 12
"d:\0_Projects\Link\miniprogram_npm\@vant\weapp\config-provider\index.json", "JSON", 0, 0, 3, 0, 0, 0, 1, 4
"d:\0_Projects\Link\miniprogram_npm\@vant\weapp\config-provider\index.wxs", "XML", 0, 0, 0, 24, 0, 0, 6, 30
"d:\0_Projects\Link\miniprogram_npm\@vant\weapp\count-down\index.d.ts", "TypeScript", 0, 0, 0, 0, 1, 0, 1, 2
"d:\0_Projects\Link\miniprogram_npm\@vant\weapp\count-down\index.js", "JavaScript", 0, 101, 0, 0, 0, 3, 1, 105
"d:\0_Projects\Link\miniprogram_npm\@vant\weapp\count-down\index.json", "JSON", 0, 0, 3, 0, 0, 0, 1, 4
"d:\0_Projects\Link\miniprogram_npm\@vant\weapp\count-down\utils.d.ts", "TypeScript", 0, 0, 0, 0, 10, 0, 1, 11
"d:\0_Projects\Link\miniprogram_npm\@vant\weapp\count-down\utils.js", "JavaScript", 0, 64, 0, 0, 0, 0, 1, 65
"d:\0_Projects\Link\miniprogram_npm\@vant\weapp\datetime-picker\index.d.ts", "TypeScript", 0, 0, 0, 0, 1, 0, 1, 2
"d:\0_Projects\Link\miniprogram_npm\@vant\weapp\datetime-picker\index.js", "JavaScript", 0, 326, 0, 0, 0, 3, 1, 330
"d:\0_Projects\Link\miniprogram_npm\@vant\weapp\datetime-picker\index.json", "JSON", 0, 0, 6, 0, 0, 0, 1, 7
"d:\0_Projects\Link\miniprogram_npm\@vant\weapp\definitions\index.d.ts", "TypeScript", 0, 0, 0, 0, 26, 1, 1, 28
"d:\0_Projects\Link\miniprogram_npm\@vant\weapp\definitions\index.js", "JavaScript", 0, 2, 0, 0, 0, 0, 1, 3
"d:\0_Projects\Link\miniprogram_npm\@vant\weapp\dialog\dialog.d.ts", "TypeScript", 0, 0, 0, 0, 46, 4, 1, 51
"d:\0_Projects\Link\miniprogram_npm\@vant\weapp\dialog\dialog.js", "JavaScript", 0, 90, 0, 0, 0, 0, 1, 91
"d:\0_Projects\Link\miniprogram_npm\@vant\weapp\dialog\index.d.ts", "TypeScript", 0, 0, 0, 0, 1, 0, 1, 2
"d:\0_Projects\Link\miniprogram_npm\@vant\weapp\dialog\index.js", "JavaScript", 0, 127, 0, 0, 0, 0, 1, 128
"d:\0_Projects\Link\miniprogram_npm\@vant\weapp\dialog\index.json", "JSON", 0, 0, 9, 0, 0, 0, 1, 10
"d:\0_Projects\Link\miniprogram_npm\@vant\weapp\divider\index.d.ts", "TypeScript", 0, 0, 0, 0, 1, 0, 1, 2
"d:\0_Projects\Link\miniprogram_npm\@vant\weapp\divider\index.js", "JavaScript", 0, 14, 0, 0, 0, 0, 1, 15
"d:\0_Projects\Link\miniprogram_npm\@vant\weapp\divider\index.json", "JSON", 0, 0, 4, 0, 0, 0, 1, 5
"d:\0_Projects\Link\miniprogram_npm\@vant\weapp\divider\index.wxs", "XML", 0, 0, 0, 16, 0, 0, 3, 19
"d:\0_Projects\Link\miniprogram_npm\@vant\weapp\dropdown-item\index.d.ts", "TypeScript", 0, 0, 0, 0, 1, 0, 1, 2
"d:\0_Projects\Link\miniprogram_npm\@vant\weapp\dropdown-item\index.js", "JavaScript", 0, 107, 0, 0, 0, 0, 1, 108
"d:\0_Projects\Link\miniprogram_npm\@vant\weapp\dropdown-item\index.json", "JSON", 0, 0, 8, 0, 0, 0, 1, 9
"d:\0_Projects\Link\miniprogram_npm\@vant\weapp\dropdown-item\shared.d.ts", "TypeScript", 0, 0, 0, 0, 5, 0, 1, 6
"d:\0_Projects\Link\miniprogram_npm\@vant\weapp\dropdown-item\shared.js", "JavaScript", 0, 2, 0, 0, 0, 0, 1, 3
"d:\0_Projects\Link\miniprogram_npm\@vant\weapp\dropdown-menu\index.d.ts", "TypeScript", 0, 0, 0, 0, 1, 0, 1, 2
"d:\0_Projects\Link\miniprogram_npm\@vant\weapp\dropdown-menu\index.js", "JavaScript", 0, 117, 0, 0, 0, 0, 1, 118
"d:\0_Projects\Link\miniprogram_npm\@vant\weapp\dropdown-menu\index.json", "JSON", 0, 0, 3, 0, 0, 0, 1, 4
"d:\0_Projects\Link\miniprogram_npm\@vant\weapp\dropdown-menu\index.wxs", "XML", 0, 0, 0, 14, 0, 0, 3, 17
"d:\0_Projects\Link\miniprogram_npm\@vant\weapp\empty\index.d.ts", "TypeScript", 0, 0, 0, 0, 1, 0, 1, 2
"d:\0_Projects\Link\miniprogram_npm\@vant\weapp\empty\index.js", "JavaScript", 0, 12, 0, 0, 0, 0, 1, 13
"d:\0_Projects\Link\miniprogram_npm\@vant\weapp\empty\index.json", "JSON", 0, 0, 4, 0, 0, 0, 1, 5
"d:\0_Projects\Link\miniprogram_npm\@vant\weapp\empty\index.wxs", "XML", 0, 0, 0, 11, 0, 0, 5, 16
"d:\0_Projects\Link\miniprogram_npm\@vant\weapp\field\index.d.ts", "TypeScript", 0, 0, 0, 0, 1, 0, 1, 2
"d:\0_Projects\Link\miniprogram_npm\@vant\weapp\field\index.js", "JavaScript", 0, 122, 0, 0, 0, 0, 1, 123
"d:\0_Projects\Link\miniprogram_npm\@vant\weapp\field\index.json", "JSON", 0, 0, 7, 0, 0, 0, 1, 8
"d:\0_Projects\Link\miniprogram_npm\@vant\weapp\field\index.wxs", "XML", 0, 0, 0, 15, 0, 0, 4, 19
"d:\0_Projects\Link\miniprogram_npm\@vant\weapp\field\props.d.ts", "TypeScript", 0, 0, 0, 0, 3, 1, 1, 5
"d:\0_Projects\Link\miniprogram_npm\@vant\weapp\field\props.js", "JavaScript", 0, 67, 0, 0, 0, 0, 1, 68
"d:\0_Projects\Link\miniprogram_npm\@vant\weapp\goods-action-button\index.d.ts", "TypeScript", 0, 0, 0, 0, 1, 0, 1, 2
"d:\0_Projects\Link\miniprogram_npm\@vant\weapp\goods-action-button\index.js", "JavaScript", 0, 38, 0, 0, 0, 0, 1, 39
"d:\0_Projects\Link\miniprogram_npm\@vant\weapp\goods-action-button\index.json", "JSON", 0, 0, 6, 0, 0, 0, 1, 7
"d:\0_Projects\Link\miniprogram_npm\@vant\weapp\goods-action-icon\index.d.ts", "TypeScript", 0, 0, 0, 0, 1, 0, 1, 2
"d:\0_Projects\Link\miniprogram_npm\@vant\weapp\goods-action-icon\index.js", "JavaScript", 0, 27, 0, 0, 0, 0, 1, 28
"d:\0_Projects\Link\miniprogram_npm\@vant\weapp\goods-action-icon\index.json", "JSON", 0, 0, 7, 0, 0, 0, 1, 8
"d:\0_Projects\Link\miniprogram_npm\@vant\weapp\goods-action\index.d.ts", "TypeScript", 0, 0, 0, 0, 1, 0, 1, 2
"d:\0_Projects\Link\miniprogram_npm\@vant\weapp\goods-action\index.js", "JavaScript", 0, 17, 0, 0, 0, 0, 1, 18
"d:\0_Projects\Link\miniprogram_npm\@vant\weapp\goods-action\index.json", "JSON", 0, 0, 3, 0, 0, 0, 1, 4
"d:\0_Projects\Link\miniprogram_npm\@vant\weapp\grid-item\index.d.ts", "TypeScript", 0, 0, 0, 0, 1, 0, 1, 2
"d:\0_Projects\Link\miniprogram_npm\@vant\weapp\grid-item\index.js", "JavaScript", 0, 54, 0, 0, 0, 0, 1, 55
"d:\0_Projects\Link\miniprogram_npm\@vant\weapp\grid-item\index.json", "JSON", 0, 0, 6, 0, 0, 0, 1, 7
"d:\0_Projects\Link\miniprogram_npm\@vant\weapp\grid-item\index.wxs", "XML", 0, 0, 0, 28, 0, 0, 5, 33
"d:\0_Projects\Link\miniprogram_npm\@vant\weapp\grid\index.d.ts", "TypeScript", 0, 0, 0, 0, 1, 0, 1, 2
"d:\0_Projects\Link\miniprogram_npm\@vant\weapp\grid\index.js", "JavaScript", 0, 57, 0, 0, 0, 0, 1, 58
"d:\0_Projects\Link\miniprogram_npm\@vant\weapp\grid\index.json", "JSON", 0, 0, 3, 0, 0, 0, 1, 4
"d:\0_Projects\Link\miniprogram_npm\@vant\weapp\grid\index.wxs", "XML", 0, 0, 0, 11, 0, 0, 3, 14
"d:\0_Projects\Link\miniprogram_npm\@vant\weapp\icon\index.d.ts", "TypeScript", 0, 0, 0, 0, 1, 0, 1, 2
"d:\0_Projects\Link\miniprogram_npm\@vant\weapp\icon\index.js", "JavaScript", 0, 22, 0, 0, 0, 0, 1, 23
"d:\0_Projects\Link\miniprogram_npm\@vant\weapp\icon\index.json", "JSON", 0, 0, 6, 0, 0, 0, 1, 7
"d:\0_Projects\Link\miniprogram_npm\@vant\weapp\icon\index.wxs", "XML", 0, 0, 0, 32, 0, 0, 8, 40
"d:\0_Projects\Link\miniprogram_npm\@vant\weapp\image\index.d.ts", "TypeScript", 0, 0, 0, 0, 1, 0, 1, 2
"d:\0_Projects\Link\miniprogram_npm\@vant\weapp\image\index.js", "JavaScript", 0, 62, 0, 0, 0, 0, 1, 63
"d:\0_Projects\Link\miniprogram_npm\@vant\weapp\image\index.json", "JSON", 0, 0, 7, 0, 0, 0, 1, 8
"d:\0_Projects\Link\miniprogram_npm\@vant\weapp\image\index.wxs", "XML", 0, 0, 0, 28, 0, 0, 5, 33
"d:\0_Projects\Link\miniprogram_npm\@vant\weapp\index-anchor\index.d.ts", "TypeScript", 0, 0, 0, 0, 1, 0, 1, 2
"d:\0_Projects\Link\miniprogram_npm\@vant\weapp\index-anchor\index.js", "JavaScript", 0, 28, 0, 0, 0, 0, 1, 29
"d:\0_Projects\Link\miniprogram_npm\@vant\weapp\index-anchor\index.json", "JSON", 0, 0, 3, 0, 0, 0, 1, 4
"d:\0_Projects\Link\miniprogram_npm\@vant\weapp\index-bar\index.d.ts", "TypeScript", 0, 0, 0, 0, 1, 0, 1, 2
"d:\0_Projects\Link\miniprogram_npm\@vant\weapp\index-bar\index.js", "JavaScript", 0, 243, 0, 0, 0, 0, 1, 244
"d:\0_Projects\Link\miniprogram_npm\@vant\weapp\index-bar\index.json", "JSON", 0, 0, 3, 0, 0, 0, 1, 4
"d:\0_Projects\Link\miniprogram_npm\@vant\weapp\info\index.d.ts", "TypeScript", 0, 0, 0, 0, 1, 0, 1, 2
"d:\0_Projects\Link\miniprogram_npm\@vant\weapp\info\index.js", "JavaScript", 0, 10, 0, 0, 0, 0, 1, 11
"d:\0_Projects\Link\miniprogram_npm\@vant\weapp\info\index.json", "JSON", 0, 0, 3, 0, 0, 0, 1, 4
"d:\0_Projects\Link\miniprogram_npm\@vant\weapp\loading\index.d.ts", "TypeScript", 0, 0, 0, 0, 1, 0, 1, 2
"d:\0_Projects\Link\miniprogram_npm\@vant\weapp\loading\index.js", "JavaScript", 0, 18, 0, 0, 0, 0, 1, 19
"d:\0_Projects\Link\miniprogram_npm\@vant\weapp\loading\index.json", "JSON", 0, 0, 3, 0, 0, 0, 1, 4
"d:\0_Projects\Link\miniprogram_npm\@vant\weapp\loading\index.wxs", "XML", 0, 0, 0, 19, 0, 0, 4, 23
"d:\0_Projects\Link\miniprogram_npm\@vant\weapp\mixins\basic.d.ts", "TypeScript", 0, 0, 0, 0, 1, 0, 1, 2
"d:\0_Projects\Link\miniprogram_npm\@vant\weapp\mixins\basic.js", "JavaScript", 0, 14, 0, 0, 0, 0, 1, 15
"d:\0_Projects\Link\miniprogram_npm\@vant\weapp\mixins\button.d.ts", "TypeScript", 0, 0, 0, 0, 1, 0, 1, 2
"d:\0_Projects\Link\miniprogram_npm\@vant\weapp\mixins\button.js", "JavaScript", 0, 44, 0, 0, 0, 0, 1, 45
"d:\0_Projects\Link\miniprogram_npm\@vant\weapp\mixins\link.d.ts", "TypeScript", 0, 0, 0, 0, 1, 0, 1, 2
"d:\0_Projects\Link\miniprogram_npm\@vant\weapp\mixins\link.js", "JavaScript", 0, 27, 0, 0, 0, 0, 1, 28
"d:\0_Projects\Link\miniprogram_npm\@vant\weapp\mixins\page-scroll.d.ts", "TypeScript", 0, 0, 0, 0, 4, 1, 1, 6
"d:\0_Projects\Link\miniprogram_npm\@vant\weapp\mixins\page-scroll.js", "JavaScript", 0, 41, 0, 0, 0, 1, 1, 43
"d:\0_Projects\Link\miniprogram_npm\@vant\weapp\mixins\touch.d.ts", "TypeScript", 0, 0, 0, 0, 1, 0, 1, 2
"d:\0_Projects\Link\miniprogram_npm\@vant\weapp\mixins\touch.js", "JavaScript", 0, 39, 0, 0, 0, 1, 1, 41
"d:\0_Projects\Link\miniprogram_npm\@vant\weapp\mixins\transition.d.ts", "TypeScript", 0, 0, 0, 0, 1, 0, 1, 2
"d:\0_Projects\Link\miniprogram_npm\@vant\weapp\mixins\transition.js", "JavaScript", 0, 118, 0, 0, 0, 3, 1, 122
"d:\0_Projects\Link\miniprogram_npm\@vant\weapp\nav-bar\index.d.ts", "TypeScript", 0, 0, 0, 0, 1, 0, 1, 2
"d:\0_Projects\Link\miniprogram_npm\@vant\weapp\nav-bar\index.js", "JavaScript", 0, 72, 0, 0, 0, 0, 1, 73
"d:\0_Projects\Link\miniprogram_npm\@vant\weapp\nav-bar\index.json", "JSON", 0, 0, 6, 0, 0, 0, 1, 7
"d:\0_Projects\Link\miniprogram_npm\@vant\weapp\nav-bar\index.wxs", "XML", 0, 0, 0, 11, 0, 0, 3, 14
"d:\0_Projects\Link\miniprogram_npm\@vant\weapp\notice-bar\index.d.ts", "TypeScript", 0, 0, 0, 0, 1, 0, 1, 2
"d:\0_Projects\Link\miniprogram_npm\@vant\weapp\notice-bar\index.js", "JavaScript", 0, 125, 0, 0, 0, 0, 1, 126
"d:\0_Projects\Link\miniprogram_npm\@vant\weapp\notice-bar\index.json", "JSON", 0, 0, 6, 0, 0, 0, 1, 7
"d:\0_Projects\Link\miniprogram_npm\@vant\weapp\notice-bar\index.wxs", "XML", 0, 0, 0, 13, 0, 0, 3, 16
"d:\0_Projects\Link\miniprogram_npm\@vant\weapp\notify\index.d.ts", "TypeScript", 0, 0, 0, 0, 1, 0, 1, 2
"d:\0_Projects\Link\miniprogram_npm\@vant\weapp\notify\index.js", "JavaScript", 0, 68, 0, 0, 0, 0, 1, 69
"d:\0_Projects\Link\miniprogram_npm\@vant\weapp\notify\index.json", "JSON", 0, 0, 6, 0, 0, 0, 1, 7
"d:\0_Projects\Link\miniprogram_npm\@vant\weapp\notify\index.wxs", "XML", 0, 0, 0, 19, 0, 0, 4, 23
"d:\0_Projects\Link\miniprogram_npm\@vant\weapp\notify\notify.d.ts", "TypeScript", 0, 0, 0, 0, 20, 0, 1, 21
"d:\0_Projects\Link\miniprogram_npm\@vant\weapp\notify\notify.js", "JavaScript", 0, 60, 0, 0, 0, 0, 1, 61
"d:\0_Projects\Link\miniprogram_npm\@vant\weapp\overlay\index.d.ts", "TypeScript", 0, 0, 0, 0, 1, 0, 1, 2
"d:\0_Projects\Link\miniprogram_npm\@vant\weapp\overlay\index.js", "JavaScript", 0, 27, 0, 0, 0, 1, 1, 29
"d:\0_Projects\Link\miniprogram_npm\@vant\weapp\overlay\index.json", "JSON", 0, 0, 6, 0, 0, 0, 1, 7
"d:\0_Projects\Link\miniprogram_npm\@vant\weapp\panel\index.d.ts", "TypeScript", 0, 0, 0, 0, 1, 0, 1, 2
"d:\0_Projects\Link\miniprogram_npm\@vant\weapp\panel\index.js", "JavaScript", 0, 11, 0, 0, 0, 0, 1, 12
"d:\0_Projects\Link\miniprogram_npm\@vant\weapp\panel\index.json", "JSON", 0, 0, 6, 0, 0, 0, 1, 7
"d:\0_Projects\Link\miniprogram_npm\@vant\weapp\picker-column\index.d.ts", "TypeScript", 0, 0, 0, 0, 1, 0, 1, 2
"d:\0_Projects\Link\miniprogram_npm\@vant\weapp\picker-column\index.js", "JavaScript", 0, 122, 0, 0, 0, 0, 1, 123
"d:\0_Projects\Link\miniprogram_npm\@vant\weapp\picker-column\index.json", "JSON", 0, 0, 3, 0, 0, 0, 1, 4
"d:\0_Projects\Link\miniprogram_npm\@vant\weapp\picker-column\index.wxs", "XML", 0, 0, 0, 30, 0, 0, 7, 37
"d:\0_Projects\Link\miniprogram_npm\@vant\weapp\picker\index.d.ts", "TypeScript", 0, 0, 0, 0, 1, 0, 1, 2
"d:\0_Projects\Link\miniprogram_npm\@vant\weapp\picker\index.js", "JavaScript", 0, 150, 0, 0, 0, 11, 1, 162
"d:\0_Projects\Link\miniprogram_npm\@vant\weapp\picker\index.json", "JSON", 0, 0, 7, 0, 0, 0, 1, 8
"d:\0_Projects\Link\miniprogram_npm\@vant\weapp\picker\index.wxs", "XML", 0, 0, 0, 35, 0, 0, 8, 43
"d:\0_Projects\Link\miniprogram_npm\@vant\weapp\picker\shared.d.ts", "TypeScript", 0, 0, 0, 0, 21, 0, 1, 22
"d:\0_Projects\Link\miniprogram_npm\@vant\weapp\picker\shared.js", "JavaScript", 0, 24, 0, 0, 0, 0, 1, 25
"d:\0_Projects\Link\miniprogram_npm\@vant\weapp\popup\index.d.ts", "TypeScript", 0, 0, 0, 0, 1, 0, 1, 2
"d:\0_Projects\Link\miniprogram_npm\@vant\weapp\popup\index.js", "JavaScript", 0, 91, 0, 0, 0, 0, 1, 92
"d:\0_Projects\Link\miniprogram_npm\@vant\weapp\popup\index.json", "JSON", 0, 0, 7, 0, 0, 0, 1, 8
"d:\0_Projects\Link\miniprogram_npm\@vant\weapp\popup\index.wxs", "XML", 0, 0, 0, 16, 0, 0, 3, 19
"d:\0_Projects\Link\miniprogram_npm\@vant\weapp\progress\index.d.ts", "TypeScript", 0, 0, 0, 0, 1, 0, 1, 2
"d:\0_Projects\Link\miniprogram_npm\@vant\weapp\progress\index.js", "JavaScript", 0, 55, 0, 0, 0, 0, 1, 56
"d:\0_Projects\Link\miniprogram_npm\@vant\weapp\progress\index.json", "JSON", 0, 0, 3, 0, 0, 0, 1, 4
"d:\0_Projects\Link\miniprogram_npm\@vant\weapp\progress\index.wxs", "XML", 0, 0, 0, 31, 0, 0, 6, 37
"d:\0_Projects\Link\miniprogram_npm\@vant\weapp\radio-group\index.d.ts", "TypeScript", 0, 0, 0, 0, 1, 0, 1, 2
"d:\0_Projects\Link\miniprogram_npm\@vant\weapp\radio-group\index.js", "JavaScript", 0, 24, 0, 0, 0, 0, 1, 25
"d:\0_Projects\Link\miniprogram_npm\@vant\weapp\radio-group\index.json", "JSON", 0, 0, 3, 0, 0, 0, 1, 4
"d:\0_Projects\Link\miniprogram_npm\@vant\weapp\radio\index.d.ts", "TypeScript", 0, 0, 0, 0, 1, 0, 1, 2
"d:\0_Projects\Link\miniprogram_npm\@vant\weapp\radio\index.js", "JavaScript", 0, 68, 0, 0, 0, 0, 1, 69
"d:\0_Projects\Link\miniprogram_npm\@vant\weapp\radio\index.json", "JSON", 0, 0, 6, 0, 0, 0, 1, 7
"d:\0_Projects\Link\miniprogram_npm\@vant\weapp\radio\index.wxs", "XML", 0, 0, 0, 28, 0, 0, 6, 34
"d:\0_Projects\Link\miniprogram_npm\@vant\weapp\rate\index.d.ts", "TypeScript", 0, 0, 0, 0, 1, 0, 1, 2
"d:\0_Projects\Link\miniprogram_npm\@vant\weapp\rate\index.js", "JavaScript", 0, 93, 0, 0, 0, 0, 1, 94
"d:\0_Projects\Link\miniprogram_npm\@vant\weapp\rate\index.json", "JSON", 0, 0, 6, 0, 0, 0, 1, 7
"d:\0_Projects\Link\miniprogram_npm\@vant\weapp\row\index.d.ts", "TypeScript", 0, 0, 0, 0, 1, 0, 1, 2
"d:\0_Projects\Link\miniprogram_npm\@vant\weapp\row\index.js", "JavaScript", 0, 26, 0, 0, 0, 0, 1, 27
"d:\0_Projects\Link\miniprogram_npm\@vant\weapp\row\index.json", "JSON", 0, 0, 3, 0, 0, 0, 1, 4
"d:\0_Projects\Link\miniprogram_npm\@vant\weapp\row\index.wxs", "XML", 0, 0, 0, 15, 0, 0, 4, 19
"d:\0_Projects\Link\miniprogram_npm\@vant\weapp\search\index.d.ts", "TypeScript", 0, 0, 0, 0, 1, 0, 1, 2
"d:\0_Projects\Link\miniprogram_npm\@vant\weapp\search\index.js", "JavaScript", 0, 88, 0, 0, 0, 4, 1, 93
"d:\0_Projects\Link\miniprogram_npm\@vant\weapp\search\index.json", "JSON", 0, 0, 6, 0, 0, 0, 1, 7
"d:\0_Projects\Link\miniprogram_npm\@vant\weapp\share-sheet\index.d.ts", "TypeScript", 0, 0, 0, 0, 1, 0, 1, 2
"d:\0_Projects\Link\miniprogram_npm\@vant\weapp\share-sheet\index.js", "JavaScript", 0, 54, 0, 0, 0, 3, 1, 58
"d:\0_Projects\Link\miniprogram_npm\@vant\weapp\share-sheet\index.json", "JSON", 0, 0, 7, 0, 0, 0, 1, 8
"d:\0_Projects\Link\miniprogram_npm\@vant\weapp\share-sheet\index.wxs", "XML", 0, 0, 0, 10, 0, 0, 3, 13
"d:\0_Projects\Link\miniprogram_npm\@vant\weapp\share-sheet\options.d.ts", "TypeScript", 0, 0, 0, 0, 1, 0, 1, 2
"d:\0_Projects\Link\miniprogram_npm\@vant\weapp\share-sheet\options.js", "JavaScript", 0, 27, 0, 0, 0, 0, 1, 28
"d:\0_Projects\Link\miniprogram_npm\@vant\weapp\share-sheet\options.json", "JSON", 0, 0, 3, 0, 0, 0, 1, 4
"d:\0_Projects\Link\miniprogram_npm\@vant\weapp\share-sheet\options.wxs", "XML", 0, 0, 0, 11, 0, 0, 4, 15
"d:\0_Projects\Link\miniprogram_npm\@vant\weapp\sidebar-item\index.d.ts", "TypeScript", 0, 0, 0, 0, 1, 0, 1, 2
"d:\0_Projects\Link\miniprogram_npm\@vant\weapp\sidebar-item\index.js", "JavaScript", 0, 32, 0, 0, 0, 0, 1, 33
"d:\0_Projects\Link\miniprogram_npm\@vant\weapp\sidebar-item\index.json", "JSON", 0, 0, 6, 0, 0, 0, 1, 7
"d:\0_Projects\Link\miniprogram_npm\@vant\weapp\sidebar\index.d.ts", "TypeScript", 0, 0, 0, 0, 1, 0, 1, 2
"d:\0_Projects\Link\miniprogram_npm\@vant\weapp\sidebar\index.js", "JavaScript", 0, 36, 0, 0, 0, 0, 1, 37
"d:\0_Projects\Link\miniprogram_npm\@vant\weapp\sidebar\index.json", "JSON", 0, 0, 3, 0, 0, 0, 1, 4
"d:\0_Projects\Link\miniprogram_npm\@vant\weapp\skeleton\index.d.ts", "TypeScript", 0, 0, 0, 0, 1, 0, 1, 2
"d:\0_Projects\Link\miniprogram_npm\@vant\weapp\skeleton\index.js", "JavaScript", 0, 48, 0, 0, 0, 0, 1, 49
"d:\0_Projects\Link\miniprogram_npm\@vant\weapp\skeleton\index.json", "JSON", 0, 0, 4, 0, 0, 0, 1, 5
"d:\0_Projects\Link\miniprogram_npm\@vant\weapp\slider\index.d.ts", "TypeScript", 0, 0, 0, 0, 1, 0, 1, 2
"d:\0_Projects\Link\miniprogram_npm\@vant\weapp\slider\index.js", "JavaScript", 0, 187, 0, 0, 0, 2, 1, 190
"d:\0_Projects\Link\miniprogram_npm\@vant\weapp\slider\index.json", "JSON", 0, 0, 3, 0, 0, 0, 1, 4
"d:\0_Projects\Link\miniprogram_npm\@vant\weapp\slider\index.wxs", "XML", 0, 0, 0, 12, 0, 0, 3, 15
"d:\0_Projects\Link\miniprogram_npm\@vant\weapp\stepper\index.d.ts", "TypeScript", 0, 0, 0, 0, 1, 0, 1, 2
"d:\0_Projects\Link\miniprogram_npm\@vant\weapp\stepper\index.js", "JavaScript", 0, 193, 0, 0, 0, 7, 1, 201
"d:\0_Projects\Link\miniprogram_npm\@vant\weapp\stepper\index.json", "JSON", 0, 0, 3, 0, 0, 0, 1, 4
"d:\0_Projects\Link\miniprogram_npm\@vant\weapp\stepper\index.wxs", "XML", 0, 0, 0, 19, 0, 0, 4, 23
"d:\0_Projects\Link\miniprogram_npm\@vant\weapp\steps\index.d.ts", "TypeScript", 0, 0, 0, 0, 1, 0, 1, 2
"d:\0_Projects\Link\miniprogram_npm\@vant\weapp\steps\index.js", "JavaScript", 0, 35, 0, 0, 0, 0, 1, 36
"d:\0_Projects\Link\miniprogram_npm\@vant\weapp\steps\index.json", "JSON", 0, 0, 6, 0, 0, 0, 1, 7
"d:\0_Projects\Link\miniprogram_npm\@vant\weapp\sticky\index.d.ts", "TypeScript", 0, 0, 0, 0, 1, 0, 1, 2
"d:\0_Projects\Link\miniprogram_npm\@vant\weapp\sticky\index.js", "JavaScript", 0, 124, 0, 0, 0, 0, 1, 125
"d:\0_Projects\Link\miniprogram_npm\@vant\weapp\sticky\index.json", "JSON", 0, 0, 3, 0, 0, 0, 1, 4
"d:\0_Projects\Link\miniprogram_npm\@vant\weapp\sticky\index.wxs", "XML", 0, 0, 0, 22, 0, 0, 4, 26
"d:\0_Projects\Link\miniprogram_npm\@vant\weapp\submit-bar\index.d.ts", "TypeScript", 0, 0, 0, 0, 1, 0, 1, 2
"d:\0_Projects\Link\miniprogram_npm\@vant\weapp\submit-bar\index.js", "JavaScript", 0, 58, 0, 0, 0, 0, 1, 59
"d:\0_Projects\Link\miniprogram_npm\@vant\weapp\submit-bar\index.json", "JSON", 0, 0, 7, 0, 0, 0, 1, 8
"d:\0_Projects\Link\miniprogram_npm\@vant\weapp\swipe-cell\index.d.ts", "TypeScript", 0, 0, 0, 0, 1, 0, 1, 2
"d:\0_Projects\Link\miniprogram_npm\@vant\weapp\swipe-cell\index.js", "JavaScript", 0, 135, 0, 0, 0, 0, 1, 136
"d:\0_Projects\Link\miniprogram_npm\@vant\weapp\swipe-cell\index.json", "JSON", 0, 0, 3, 0, 0, 0, 1, 4
"d:\0_Projects\Link\miniprogram_npm\@vant\weapp\switch\index.d.ts", "TypeScript", 0, 0, 0, 0, 1, 0, 1, 2
"d:\0_Projects\Link\miniprogram_npm\@vant\weapp\switch\index.js", "JavaScript", 0, 38, 0, 0, 0, 0, 1, 39
"d:\0_Projects\Link\miniprogram_npm\@vant\weapp\switch\index.json", "JSON", 0, 0, 6, 0, 0, 0, 1, 7
"d:\0_Projects\Link\miniprogram_npm\@vant\weapp\switch\index.wxs", "XML", 0, 0, 0, 21, 0, 0, 6, 27
"d:\0_Projects\Link\miniprogram_npm\@vant\weapp\tab\index.d.ts", "TypeScript", 0, 0, 0, 0, 1, 0, 1, 2
"d:\0_Projects\Link\miniprogram_npm\@vant\weapp\tab\index.js", "JavaScript", 0, 58, 0, 0, 0, 0, 1, 59
"d:\0_Projects\Link\miniprogram_npm\@vant\weapp\tab\index.json", "JSON", 0, 0, 3, 0, 0, 0, 1, 4
"d:\0_Projects\Link\miniprogram_npm\@vant\weapp\tabbar-item\index.d.ts", "TypeScript", 0, 0, 0, 0, 1, 0, 1, 2
"d:\0_Projects\Link\miniprogram_npm\@vant\weapp\tabbar-item\index.js", "JavaScript", 0, 58, 0, 0, 0, 0, 1, 59
"d:\0_Projects\Link\miniprogram_npm\@vant\weapp\tabbar-item\index.json", "JSON", 0, 0, 7, 0, 0, 0, 1, 8
"d:\0_Projects\Link\miniprogram_npm\@vant\weapp\tabbar\index.d.ts", "TypeScript", 0, 0, 0, 0, 1, 0, 1, 2
"d:\0_Projects\Link\miniprogram_npm\@vant\weapp\tabbar\index.js", "JavaScript", 0, 68, 0, 0, 0, 0, 1, 69
"d:\0_Projects\Link\miniprogram_npm\@vant\weapp\tabbar\index.json", "JSON", 0, 0, 3, 0, 0, 0, 1, 4
"d:\0_Projects\Link\miniprogram_npm\@vant\weapp\tabs\index.d.ts", "TypeScript", 0, 0, 0, 0, 1, 0, 1, 2
"d:\0_Projects\Link\miniprogram_npm\@vant\weapp\tabs\index.js", "JavaScript", 0, 279, 0, 0, 0, 3, 1, 283
"d:\0_Projects\Link\miniprogram_npm\@vant\weapp\tabs\index.json", "JSON", 0, 0, 7, 0, 0, 0, 1, 8
"d:\0_Projects\Link\miniprogram_npm\@vant\weapp\tabs\index.wxs", "XML", 0, 0, 0, 69, 0, 0, 14, 83
"d:\0_Projects\Link\miniprogram_npm\@vant\weapp\tag\index.d.ts", "TypeScript", 0, 0, 0, 0, 1, 0, 1, 2
"d:\0_Projects\Link\miniprogram_npm\@vant\weapp\tag\index.js", "JavaScript", 0, 23, 0, 0, 0, 0, 1, 24
"d:\0_Projects\Link\miniprogram_npm\@vant\weapp\tag\index.json", "JSON", 0, 0, 6, 0, 0, 0, 1, 7
"d:\0_Projects\Link\miniprogram_npm\@vant\weapp\tag\index.wxs", "XML", 0, 0, 0, 11, 0, 0, 3, 14
"d:\0_Projects\Link\miniprogram_npm\@vant\weapp\toast\index.d.ts", "TypeScript", 0, 0, 0, 0, 1, 0, 1, 2
"d:\0_Projects\Link\miniprogram_npm\@vant\weapp\toast\index.js", "JavaScript", 0, 30, 0, 0, 0, 1, 1, 32
"d:\0_Projects\Link\miniprogram_npm\@vant\weapp\toast\index.json", "JSON", 0, 0, 9, 0, 0, 0, 1, 10
"d:\0_Projects\Link\miniprogram_npm\@vant\weapp\toast\toast.d.ts", "TypeScript", 0, 0, 0, 0, 25, 1, 1, 27
"d:\0_Projects\Link\miniprogram_npm\@vant\weapp\toast\toast.js", "JavaScript", 0, 81, 0, 0, 0, 0, 1, 82
"d:\0_Projects\Link\miniprogram_npm\@vant\weapp\transition\index.d.ts", "TypeScript", 0, 0, 0, 0, 1, 0, 1, 2
"d:\0_Projects\Link\miniprogram_npm\@vant\weapp\transition\index.js", "JavaScript", 0, 15, 0, 0, 0, 0, 1, 16
"d:\0_Projects\Link\miniprogram_npm\@vant\weapp\transition\index.json", "JSON", 0, 0, 3, 0, 0, 0, 1, 4
"d:\0_Projects\Link\miniprogram_npm\@vant\weapp\transition\index.wxs", "XML", 0, 0, 0, 15, 0, 0, 3, 18
"d:\0_Projects\Link\miniprogram_npm\@vant\weapp\tree-select\index.d.ts", "TypeScript", 0, 0, 0, 0, 1, 0, 1, 2
"d:\0_Projects\Link\miniprogram_npm\@vant\weapp\tree-select\index.js", "JavaScript", 0, 65, 0, 0, 0, 5, 1, 71
"d:\0_Projects\Link\miniprogram_npm\@vant\weapp\tree-select\index.json", "JSON", 0, 0, 8, 0, 0, 0, 1, 9
"d:\0_Projects\Link\miniprogram_npm\@vant\weapp\tree-select\index.wxs", "XML", 0, 0, 0, 9, 0, 0, 4, 13
"d:\0_Projects\Link\miniprogram_npm\@vant\weapp\uploader\index.d.ts", "TypeScript", 0, 0, 0, 0, 1, 0, 1, 2
"d:\0_Projects\Link\miniprogram_npm\@vant\weapp\uploader\index.js", "JavaScript", 0, 170, 0, 0, 0, 0, 1, 171
"d:\0_Projects\Link\miniprogram_npm\@vant\weapp\uploader\index.json", "JSON", 0, 0, 7, 0, 0, 0, 1, 8
"d:\0_Projects\Link\miniprogram_npm\@vant\weapp\uploader\index.wxs", "XML", 0, 0, 0, 15, 0, 0, 3, 18
"d:\0_Projects\Link\miniprogram_npm\@vant\weapp\uploader\shared.d.ts", "TypeScript", 0, 0, 0, 0, 28, 0, 1, 29
"d:\0_Projects\Link\miniprogram_npm\@vant\weapp\uploader\shared.js", "JavaScript", 0, 31, 0, 0, 0, 2, 1, 34
"d:\0_Projects\Link\miniprogram_npm\@vant\weapp\uploader\utils.d.ts", "TypeScript", 0, 0, 0, 0, 22, 0, 1, 23
"d:\0_Projects\Link\miniprogram_npm\@vant\weapp\uploader\utils.js", "JavaScript", 0, 102, 0, 0, 0, 0, 1, 103
"d:\0_Projects\Link\miniprogram_npm\@vant\weapp\wxs\add-unit.wxs", "XML", 0, 0, 0, 9, 0, 0, 4, 13
"d:\0_Projects\Link\miniprogram_npm\@vant\weapp\wxs\array.wxs", "XML", 0, 0, 0, 4, 0, 0, 2, 6
"d:\0_Projects\Link\miniprogram_npm\@vant\weapp\wxs\bem.wxs", "XML", 0, 0, 0, 34, 0, 0, 6, 40
"d:\0_Projects\Link\miniprogram_npm\@vant\weapp\wxs\memoize.wxs", "XML", 0, 0, 0, 46, 0, 0, 10, 56
"d:\0_Projects\Link\miniprogram_npm\@vant\weapp\wxs\object.wxs", "XML", 0, 0, 0, 11, 0, 0, 3, 14
"d:\0_Projects\Link\miniprogram_npm\@vant\weapp\wxs\style.wxs", "XML", 0, 0, 0, 36, 0, 0, 7, 43
"d:\0_Projects\Link\miniprogram_npm\@vant\weapp\wxs\utils.wxs", "XML", 0, 0, 0, 9, 0, 0, 2, 11
"d:\0_Projects\Link\package-lock.json", "JSON", 0, 0, 24, 0, 0, 0, 1, 25
"d:\0_Projects\Link\package.json", "JSON", 0, 0, 5, 0, 0, 0, 1, 6
"d:\0_Projects\Link\pages\home\home.js", "JavaScript", 0, 181, 0, 0, 0, 7, 7, 195
"d:\0_Projects\Link\pages\home\home.json", "JSON", 0, 0, 6, 0, 0, 0, 0, 6
"d:\0_Projects\Link\pages\index\index.js", "JavaScript", 0, 136, 0, 0, 0, 13, 9, 158
"d:\0_Projects\Link\pages\index\index.json", "JSON", 0, 0, 7, 0, 0, 0, 0, 7
"d:\0_Projects\Link\pages\login\login.js", "JavaScript", 0, 104, 0, 0, 0, 43, 23, 170
"d:\0_Projects\Link\pages\login\login.json", "JSON", 0, 0, 3, 0, 0, 0, 0, 3
"d:\0_Projects\Link\pages\member\autorenew.js", "JavaScript", 0, 18, 0, 0, 0, 3, 3, 24
"d:\0_Projects\Link\pages\member\autorenew.json", "JSON", 0, 0, 3, 0, 0, 0, 0, 3
"d:\0_Projects\Link\pages\member\exchange.js", "JavaScript", 0, 55, 0, 0, 0, 5, 13, 73
"d:\0_Projects\Link\pages\member\exchange.json", "JSON", 0, 0, 3, 0, 0, 0, 0, 3
"d:\0_Projects\Link\pages\member\openMember.js", "JavaScript", 0, 174, 0, 0, 0, 17, 14, 205
"d:\0_Projects\Link\pages\member\openMember.json", "JSON", 0, 0, 3, 0, 0, 0, 0, 3
"d:\0_Projects\Link\pages\order\coupon.js", "JavaScript", 0, 81, 0, 0, 0, 8, 6, 95
"d:\0_Projects\Link\pages\order\coupon.json", "JSON", 0, 0, 4, 0, 0, 0, 0, 4
"d:\0_Projects\Link\pages\order\order.js", "JavaScript", 0, 117, 0, 0, 0, 14, 1, 132
"d:\0_Projects\Link\pages\order\order.json", "JSON", 0, 0, 3, 0, 0, 0, 0, 3
"d:\0_Projects\Link\pages\order\orderDetail.js", "JavaScript", 0, 81, 0, 0, 0, 17, 8, 106
"d:\0_Projects\Link\pages\order\orderDetail.json", "JSON", 0, 0, 3, 0, 0, 0, 0, 3
"d:\0_Projects\Link\pages\sport\body.js", "JavaScript", 0, 222, 0, 0, 0, 34, 22, 278
"d:\0_Projects\Link\pages\sport\body.json", "JSON", 0, 0, 4, 0, 0, 0, 0, 4
"d:\0_Projects\Link\pages\sport\plan.js", "JavaScript", 0, 119, 0, 0, 0, 11, 13, 143
"d:\0_Projects\Link\pages\sport\plan.json", "JSON", 0, 0, 2, 0, 0, 0, 1, 3
"d:\0_Projects\Link\pages\sport\sport.js", "JavaScript", 0, 231, 0, 0, 0, 9, 22, 262
"d:\0_Projects\Link\pages\sport\sport.json", "JSON", 0, 0, 4, 0, 0, 0, 1, 5
"d:\0_Projects\Link\pages\sport\vitality.js", "JavaScript", 0, 75, 0, 0, 0, 9, 6, 90
"d:\0_Projects\Link\pages\sport\vitality.json", "JSON", 0, 0, 3, 0, 0, 0, 0, 3
"d:\0_Projects\Link\pages\store\store.js", "JavaScript", 0, 21, 0, 0, 0, 1, 4, 26
"d:\0_Projects\Link\pages\store\store.json", "JSON", 0, 0, 3, 0, 0, 0, 0, 3
"d:\0_Projects\Link\pages\user\agreement.js", "JavaScript", 0, 141, 0, 0, 0, 78, 3, 222
"d:\0_Projects\Link\pages\user\agreement.json", "JSON", 0, 0, 3, 0, 0, 0, 0, 3
"d:\0_Projects\Link\pages\user\opinion.js", "JavaScript", 0, 35, 0, 0, 0, 1, 3, 39
"d:\0_Projects\Link\pages\user\opinion.json", "JSON", 0, 0, 4, 0, 0, 0, 0, 4
"d:\0_Projects\Link\pages\user\profile.js", "JavaScript", 0, 108, 0, 0, 0, 7, 9, 124
"d:\0_Projects\Link\pages\user\profile.json", "JSON", 0, 0, 3, 0, 0, 0, 0, 3
"d:\0_Projects\Link\pages\user\user.js", "JavaScript", 0, 117, 0, 0, 0, 7, 7, 131
"d:\0_Projects\Link\pages\user\user.json", "JSON", 0, 0, 5, 0, 0, 0, 0, 5
"d:\0_Projects\Link\pages\user\userinfo.js", "JavaScript", 0, 44, 0, 0, 0, 1, 9, 54
"d:\0_Projects\Link\pages\user\userinfo.json", "JSON", 0, 0, 4, 0, 0, 0, 0, 4
"d:\0_Projects\Link\project.config.json", "JSON", 0, 0, 65, 0, 0, 0, 0, 65
"d:\0_Projects\Link\project.private.config.json", "JSON", 0, 0, 8, 0, 0, 0, 0, 8
"d:\0_Projects\Link\sitemap.json", "JSON", 0, 0, 10, 0, 0, 0, 0, 10
"d:\0_Projects\Link\utils\format.wxs", "XML", 0, 0, 0, 41, 0, 0, 3, 44
"d:\0_Projects\Link\utils\request.js", "JavaScript", 0, 18, 0, 0, 0, 0, 2, 20
"d:\0_Projects\Link\utils\util.js", "JavaScript", 0, 65, 0, 0, 0, 2, 9, 76
"d:\0_Projects\Link\utils\wxcharts.js", "JavaScript", 0, 1752, 0, 0, 0, 57, 251, 2060
"d:\0_Projects\Link\记录.md", "Markdown", 8, 0, 0, 0, 0, 0, 2, 10
"Total", "-", 8, 11274, 614, 1091, 358, 473, 976, 14794